Maria Jose
0111111111
0R00000001
1000000001
1000000001
1000000001
1000000001
1000000001
1000000001
1000000001
1111111111
